#############B######
############# ######
#    ######## ######
# ## ######## ##   #
# ##          ## # #
# ############## # #
#                # #
################## #
##              ## #
## ############ ## #
## #        ### ## #
##   ###### ### ## #
########### ### ## #
########    ###    #
########A###########