##########B#########
#      ###      ####
# #### ########   ##
# ####     #   ##  #
# ######## # # ### #
#       ## # #     #
####### ## # #######
#   ### ## #       #
# # ### ## ####### #
# # ### ##         #
# #  ## ############
# ## ##           ##
# ## ############ ##
# ##              ##
#A##################